*********************** *****************
*           *     *   * *               *
* ***** *** * *** *** * ***** *** ***** *
*     * * *   *   *   *     * *   * *   *
******* * ***** *** * ***** *** *** * ***
*       *   *   *   *     *     *   * * *
* ******* * * ***** ***** ******* * * * *
*     *   *   *   *   * *   *     *   * *
* *** *** ***** * *** * * *** ********* *
* * *   *       *     *   *   *         *
* * *** ********* ********* ********* * *
*   * *     *   * *     *   *       * * *
*** * ***** * *** * *** * *** ***** * * *
*   *   *   *     * * *   *   *       * *
* ***** * *** ***** * ***** * ********* *
*       * *     *   *   *   *     *     *
***** *** ***** * *** * ***** *** * *****
*     *   *   * *     *     * *   *     *
* ***** *** * ************* *** ******* *
* *   *     * *           *     *     * *
*** * *** *** * *** ***** ******* *** * *
*   *   *   *     * *   * *     *   *   *
* ***** ******* *** * *** * *** *** *****
*   *         * *   *   * * *     * *   *
* * ********* *** *** * * *** * *** * ***
* *   *     *     *   *       * *   *   *
* *** ***** ***** *************** ***** *
*   *     *       *     *     *   *     *
*** ***** * ******* *** * *** * *** * ***
*   * *   *     *   *   * * *   * * *   *
* *** * ********* *** *** * ***** * *** *
*   * *       *   *   *   *   *       * *
*** * ******* * *** * * *** * ***** *** *
*   *     * * *   * * *     *     * *   *
* *** *** * * *** * ************* *** * *
*   * *   * *   * *             *     * *
*** * * *** * *** *** ********* ******* *
* *   * *   * *   * * *               * *
* ***** *** * * *** * ***************** *
*           *       *                   *
************************************* ***
